#########################
#M        #             #
###### ########## #### ##
#         #        #    #
### ####### ######## ####
#             #         #
############### #########
#               #       #
####### ############# ###
#          #            #
## ############# ###### #
#                  #    #
#### ####### ####### ####
#                 #     E
#########################
